10010110111100010111
00001110000101111011
011100100101000011010
001001110000010110000
011100100101000011010
001001110000010110000
011100100101000011010
110110001111101001111
011100100101000011010
110110001111101001111
100011011010111100101
110110001111101001111
100011011010111100101
110110001111101001111
011100100101000011010
001001110000010110000
100011011010111100101
001001110000010110000
100011011010111100101
001001110000010110000
011100100101000011010
110110001111101001111
011100100101000011010
